I.......
.#......
.#......
.#......
.#......
.####...
........
........
.......T
